lemma	anagrams
意味	['口心未音']
学校	['交子栄']
企業	['並人未止']
調査	['且周木言']
説明	['日脱言']
中心	['忠']
相談	['木炎目言']
障害	['口宰日邦']
結婚	['吉女日紙']
保護	['中伎木誰', '中伎椎言', '中伎言集', '中休支誰', '中休計隻', '中信支椎', '中信支集', '中休十又誰', '中休十言隻', '中信十又椎', '中信十又集', '中信十木隻']
市場	['一主巾易']
時期	['基寸明', '基日肘', '八寺旦骨', '基寸日月', '一八寺日骨', '八寸日王骨']
検討	['人合村言', '人口大村言', '人合寸木言', '人口大寸木言']
絶対	['寸紋色']
総合	['公心給']
検査	['且人合林', '且人口大林']
特定	['一守牛走']
目標	['相票']
調整	['周政束言']
材料	['才斗木米']
改正	['己政']
神経	['又社紳']
提出	['拙是']
直接	['且土女拉', '且士女拉', '一且十女拉']
機械	['幾戒林']
感情	['憾青']
記念	['今忌言', '今己心言']
女子	['好']
格好	['各女子木']
議員	['唄義言']
保育	['一休胎', '一休台月', '一仏口月木']
資格	['木次賂']
背景	['京北明', '京北日月']
直接	['且土女拉', '且士女拉', '一且十女拉']
保障	['休早部', '休早陪', '休十日部', '休十日陪']
審査	['宜木番']
保全	['人休呈']
一時	['寺旦', '寸日王']
解釈	['刃尺牛米角']
標準	['十椎漂', '十漂集', '椎汁票', '汁票集']
少女	['妙']
活躍	['口止濯舌']
緊張	['又弓糸臣長']
感染	['九心木減']
時計	['早詩', '十日詩', '寺早言', '十寺日言']
合計	['古大言', '一人古言', '人口土言', '人口士言', '十口大言', '一人十口言']
機構	['井再幾林']
概念	['今心既木']
記者	['己諸']
主体	['住本']
加工	['功口']
機器	['口品幾木犬']
権力	['勧木']
分類	['犬米頒']
基盤	['八段王皿舟']
取材	['又才木耳']
翌日	['羽音']
温度	['日渡皿']
支持	['寺技']
構築	['丼再工木机竹', '井再凡工林竹']
要件	['価女牛']
一旦	['二日']
土曜	['堆日羽']
保有	['休右月']
趣味	['取口未走', '又口未耳走']
体育	['一仏月本']
統合	['充給']
読者	['売諸']
合意	['口大心音', '一人口心音']
原理	['厘小皇']
顧客	['雇額']
吸収	['又及叫']
体系	['係本']
育児	['充旧月']
答弁	['二介台竹']
講師	['一井再帥言']
結合	['吉給']
早期	['八十旦骨', '八土日骨', '八士日骨', '一八十日骨']
講演	['一八宙溝言', '一溝由穴言', '一井再油穴言']
集合	['口大椎', '唯大木', '一人口椎', '一人唯木']
構想	['井再心木相', '井再心林目']
幹部	['人古干障', '人十口干障', '人十干早陪']
排出	['拙非']
路線	['口止泉絡']
平等	['坪寸竹']
農村	['曲木辱']
総会	['公心絵']
兵器	['丘八口品犬']
講習	['井再白羽言']
賠償	['位員賞', '位唄賞']
法則	['去測']
特例	['件列寺', '侍列牛']
意欲	['心欠谷音']
接触	['女拉虫角']
合格	['口各大木', '一人口各木']
認可	['口忍訂']
濃度	['渡農']
幸福	['一口平田社']
法的	['勺去泊']
同盟	['日皿胴']
共済	['斉洪']
見学	['子覚']
保管	['休口官竹']
誘導	['秀討道', '寸秀言道']
翻訳	['尺番羽言', '田羽言釈']
教員	['口孝敗']
業界	['並介未田']
体調	['信周本']
接種	['委拉重']
直線	['土泉組', '士泉組', '一十泉組']
書店	['上唐旦', '一上唐日']
日程	['呈香', '和旺']
同法	['去洞']
調節	['即周竹言']
子宮	['呂字']
衝突	['犬穴行重']
最悪	['亜又恥日', '亜取心日', '亜又心日耳']
木材	['才林']
移植	['土多木租', '士多木租', '一十多木租']
講義	['井再議']
警部	['敬言陪']
演技	['一又抽汁穴']
異議	['共田義言']
本件	['体牛']
歌詞	['可司吹訂', '口可司欠訂']
器具	['一且八口品犬']
期日	['八旦骨']
立法	['去泣']
木曜	['日椎羽', '日羽集']
調停	['亭信周']
明記	['己日月言']
儀式	['代工義']
内線	['泉納']
特集	['堆村牛', '寺椎牛', '堆寸木牛']
良好	['娘子']
支部	['十又陪']
集積	['木稚責']
石炭	['岩灰']
鑑定	['監錠']
好意	['女子心音']
包括	['抱舌']
経路	['又吐止絡']
大将	['奨']
大胆	['天明', '天日月']
動員	['賀重']
耐震	['辱需']
反論	['内又斤計', '内支斤言', '内十又斤言']
融合	['中二内虫西', '一中二兄内虫']
管轄	['官害竹車']
原油	['源由']
集計	['十木誰', '十椎言']
調味	['口周未言']
抽出	['拙由']
樹木	['十寸林豆']
細工	['田紅']
交際	['祭郊']
特異	['共寺牛田']
妄想	['女忘相', '女心木盲', '女忘木目']
教材	['孝才枚']
感性	['憾生']
主演	['一八宙注', '一注由穴']
種子	['季重']
阻害	['口宜邦']
公庫	['八広車']
解答	['召大牛竹角', '一人召牛竹角']
立体	['位本']
干渉	['歩汗']
好調	['周女子言']
計測	['則汁言']
学力	['労子']
付則	['側寸']
時価	['一中侍旧', '中付旧王']
一二	['三']
臓器	['口品月犬蔵', '口品月犬臣茂']
同等	['寺筒']
集約	['勺木維']
感激	['心放減白']
導体	['付本道']
常時	['堂寸巾日']
提唱	['一捉晶']
方言	['訪']
収縮	['又宿糾']
真相	['植貝', '八植目', '土査貝', '士査貝', '木直貝', '一十査貝', '且土木貝', '且士木貝', '八土査目', '八士査目', '八木目直', '具十木目', '一且十木貝', '一八十査目', '且八土木目', '且八士木目', '一且八十木目']
婚約	['勺女日紙']
格闘	['村豆閣', '各寸豆閑', '寸木豆閣']
診査	['且人杉言']
大腸	['天易月']
帳簿	['寸巾浦竹長']
機体	['休幾本']
資材	['木次財']
重力	['動']
増強	['去弓曽虫']
線路	['口止泉絡']
転倒	['伝到車']
演習	['油百穴羽', '一八宙泊羽', '一油白穴羽', '一泊由穴羽']
拠出	['処拙']
校舎	['交人吐木']
案件	['休安牛']
異動	['共男重']
模型	['刑墓木']
専業	['一並寸未由']
原型	['刑圧小白']
媒体	['休女本甘']
専念	['今寸恵', '一今寸心由']
公認	['忍訟']
過激	['放渦迫']
仲裁	['伐十衷']
回想	['口困心目']
樹脂	['十旨月村豆', '十旨木肘豆', '十寸旨月木豆']
聖人	['全口耳']
透析	['木秀近']
樹立	['村豆辛', '寸木豆辛']
消去	['法肖']
着工	['差目']
土台	['去口']
合法	['人治王']
土器	['吐品犬']
相応	['床心目']
薬品	['串古楽', '中口古楽', '串十口楽']
風潮	['千日汁肌虫']
整合	['口大政束', '一人口政束']
公債	['仏八責']
軽量	['又埋旦車', '一又埋日車']
空想	['工心相穴', '工心木目穴']
増幅	['一吐巾曽田', '口巾曽王田']
力学	['労子']
内緒	['納者']
恐縮	['凡宿心紅']
空洞	['同江穴']
一大	['天']
連隊	['遂陣']
浴室	['溶至']
突如	['八口安犬', '口女犬穴']
鉱業	['並広未金']
同人	['一内口']
辛抱	['包十拉']
情景	['憬青']
大師	['天帥']
窃盗	['切次皿穴']
破損	['員拓皮', '唄拓皮']
未婚	['女昧氏', '妹日氏']
根性	['恨木生']
欠如	['吹女']
誠意	['心成言音']
好感	['口威子心']
最期	['八取旦骨', '一八取日骨', '八又旦耳骨', '一八又日耳骨']
思案	['安心木田']
主治	['台注']
共演	['一八宙洪', '一洪由穴']
次女	['姿']
直結	['吉土組', '吉士組', '一十吉組']
種別	['刀利口重', '利力口重']
溶接	['安拉浴']
架空	['功口木穴', '加工木穴']
真空	['八工直穴', '具十工穴', '且八土工穴', '且八士工穴', '一且八十工穴']
古今	['十吟', '十含']
吟味	['口含未']
機材	['幾才林']
心中	['忠']
作詞	['伺詐']
借款	['仕昔欠示']
慰謝	['射尉心言', '尉心討身', '寸尉心言身']
標的	['勺木白票']
混同	['昆洞', '日比洞']
多種	['移重']
採集	['推木采']
試料	['式斗米言']
究明	['九日月穴']
仮想	['休反心目']
体格	['休各本']
直轄	['且土害車', '且士害車', '一且十害車']
工法	['去江']
異例	['供列田']
含有	['今右月']
音波	['日泣皮']
感慨	['憾既']
吸引	['中及弓', '及口弔']
悪臭	['亜息犬', '亜心犬自']
接客	['各安拉']
酸味	['公未酪']
骨盤	['月段皿舟']
結集	['吉木維']
花壇	['一主化固旧', '主化回土旧', '主化回士旧', '一主化十回旧']
暗黙	['日犬音黒']
試作	['代工詐']
詩集	['堆木討', '堆村言', '寺木誰', '寺椎言', '堆寸木言']
招集	['召推木']
定時	['堤守', '守旦走', '一守日走']
音量	['日旦童']
間伐	['日閥']
成型	['刑城']
容姿	['安次谷']
最古	['取口早', '十取口日', '又口早耳', '口支日耳', '十又口日耳']
真意	['具心章', '八心直音', '具十心音', '具心日辛', '一且八心章', '且八土心音', '且八士心音', '且八心旦辛', '一且八十心音', '一且八心日辛']
歓喜	['一午唯欠豆']
繁盛	['成敏皿糸']
接合	['大如拉', '一人如拉', '口大女拉', '一人口女拉']
鎮静	['争具針青', '争真金青', '争八直金青', '争具十金青', '一且争八針青', '且争八土金青', '且争八士金青', '一且争八十金青']
倍増	['位吐曽']
異論	['一共内苗言']
略奪	['各奮寸']
窮屈	['弓窟身']
改築	['凡工己枚竹', '凡己攻木竹']
辞儀	['位十義舌']
中佐	['仲左']
月給	['大絹', '一人絹']
真宗	['直示穴', '且土示穴', '且士示穴', '八土宜示', '八士宜示', '一且十示穴', '一八十宜示']
炭鉱	['山広灰金']
固体	['個本']
特攻	['寺工牧']
同月	['胴']
絶叫	['口糾色']
材木	['才林']
暗記	['己日言音']
党員	['兄賞']
累計	['十田糸言']
校庭	['交床廷']
同胞	['包胴']
委嘱	['和女属']
激怒	['奴心放泊', '又女心放泊']
真摯	['八執手直', '具十執手', '且八土執手', '且八執士手', '一且八十執手']
大義	['我美']
合弁	['二介台']
集結	['吉木維']
細分	['田紛']
激突	['放泊犬穴']
精製	['制米衣青']
特製	['制寺牛衣']
部員	['唄陪']
真言	['具計', '一且八計']
銃弾	['充単弓金']
落胆	['一各旧月汁']
体裁	['伐十本衣']
簿記	['己浦竹討', '寸己浦竹言']
準拠	['処推汁']
議案	['安木義言']
合算	['二介口目竹']
基板	['坂棋']
約定	['勺綻']
苦心	['古芯', '十口芯']
査察	['宜木祭']
資機材	['幾林次財']
真偽	['値八為']
謀反	['板甘言']
兵法	['去浜']
肝要	['干腰']
恒星	['一性日旦']
恩師	['一因帥心']
簡略	['各田竹間', '日田竹閣']
誘引	['弔秀言']
弾薬	['十単弔楽', '十単引楽']
寄託	['奇宅言']
未明	['昧月']
談合	['口大炎言', '一人口炎言']
概略	['既格田', '各既木田']
月報	['幸服']
最盛	['取成日皿', '又成日皿耳']
腸管	['一官易月竹']
触媒	['女某虫角', '女木甘虫角']
割賦	['則害武']
時空	['寺工日穴']
業態	['並心未能']
信奉	['俸言']
射精	['寸米身青']
植林	['森直', '且土森', '且士森', '一且十森']
停戦	['亭伐単']
付記	['信寸己']
禁固	['困枯示', '十回林示', '古困木示', '十口困木示']
窒息	['八室心自', '心穴自至']
記帳	['己巾言長']
禁忌	['己心林示']
部材	['才木陪']
直立	['一且辛']
特技	['持支牛', '十又持牛']
優等	['侍憂竹']
演歌	['一八可宙欠河', '一可欠河由穴']
管弦	['官弓玄竹']
製材	['制才木衣']
加担	['拐旦', '一拐日']
枯渇	['匂口果汁', '句旨木汁', '匂口日木汁']
好機	['女子幾木']
合板	['人又后木', '反口大木', '一人反口木']
子女	['好']
信義	['儀言']
精液	['夜清米']
苦境	['児十吐辛']
照準	['早沼焦', '昭汁焦', '十日沼焦', '召日汁焦']
加重	['動口']
省力	['劣目']
樹齢	['令十村歯豆', '令十寸木歯豆']
法度	['去渡']
植樹	['十土村査豆', '十士村査豆', '十寸林直豆', '十木村直豆', '且十土寸林豆', '且十土木村豆', '且十士寸林豆', '且十士木村豆', '十土寸木査豆', '十士寸木査豆']
線分	['泉紛']
台座	['人広舎']
格好	['各女子木']
計器	['古品犬言', '十口品犬言']
一躍	['唯正羽']
糖分	['唐粉']
搬出	['拙般']
普請	['譜青']
音源	['原日泣']
全校	['交栓']
腸内	['丙易月']
試着	['式目詳']
直腸	['一且土易月', '一且士易月', '且二十易月']
屈指	['掘旨', '尼拙日']
一路	['口各正']
鍵盤	['建皿般金']
公言	['訟']
香料	['日科米']
賢者	['又臣賭']
機銃	['充幾木金']
休戦	['伐単木']
空調	['周工穴言']
淡白	['泊炎']
廃車	['庫発']
新薬	['楽薪']
調製	['制周衣言']
漂白	['泊票']
校区	['交枢']
鎮守	['寸直穴金', '一且寸穴針', '一八宜寸針', '且土寸穴金', '且士寸穴金', '八土宜寸金', '八士宜寸金', '一且十寸穴金', '一八十宜寸金']
木簡	['日竹閑']
主査	['且柱']
謀略	['各某田言', '格甘田言', '各木甘田言']
如意	['口女心音']
精油	['清由米']
口論	['一中内計', '中内土言', '中内士言', '一中内十言']
導管	['官寸竹道']
各界	['介略']
習俗	['伯羽谷']
音符	['位寸日竹']
肢体	['伎月本']
悲哀	['口心衣非']
漂着	['洋目票']
薬味	['中十未楽']
育種	['一私腫', '一月私重']
樹林	['十寸森豆']
退陣	['連限']
日朝	['十早明']
俳諧	['信皆非', '伯比言非', '信比白非']
高率	['古商玄', '十口商玄']
仮装	['依反壮']
工員	['口貢']
勉学	['免労子']
直訳	['一且尺計', '且土尺言', '且士尺言', '一且十尺言']
合議	['口大義言', '一人口義言']
平時	['坪寸日']
凝集	['准木疑']
始業	['並台妹', '並台女未']
直射	['且土寸身', '且士寸身', '一且十寸身']
精査	['木粗青', '且木米青']
器械	['口品戒木犬']
不可思議	['否心田義訂', '否心町義言']
幅員	['一口唄巾田']
体臭	['伏本自']
検問	['人口合閑']
最愛	['取曖', '又曖耳']
訳者	['尺諸']
校門	['交閑']
詩的	['勺寺白言']
貼付	['偵口寸']
閉口	['問才']
口臭	['嗅']
公報	['八却又平']
克明	['兄早月', '兄十日月']
半信	['伴言']
銃器	['充口品犬金', '一口台呪犬金']
農法	['去濃']
真人	['火直', '且土火', '且士火', '一且十火', '且八十大']
結界	['介吉細']
公儀	['仏八義']
捻出	['念拙', '今心拙']
具材	['一八才査', '一且八才木']
採石	['拓采']
兵員	['丘八唄']
暗唱	['口晶音']
蔵相	['木目臣茂']
話者	['舌諸']
原題	['是願']
詩歌	['可吹寺訂', '口可寺欠訂', '可吐寸欠訂']
失速	['束迭']
付表	['俵寸']
即答	['合節', '口大節', '一人口節']
異臭	['共犬田自']
試案	['安式木言']
装具	['一且八壮衣']
相似	['以休目']
販路	['反口止賂', '反各員止', '反各唄止']
工賃	['任貢']
特捜	['又持牛申']
格調	['各周木言']
黙認	['忍犬言黒']
腰椎	['月要集']
監護	['又藍誰', '藍言隻']
焼香	['暁秋', '元千旧秋']
心中	['忠']
情感	['憾青']
星雲	['曇生']
盛衰	['一哀成皿', '一口成皿衣']
検分	['召大木火', '一人召木火', '人八召大木']
左腕	['宛工有']
全日	['人旺']
可燃	['口灯然']
妙法	['去女沙']
白昼	['尺日百']
禁欲	['林欠示谷']
調合	['口周大言', '一人口周言']
特記	['己牛詩', '寺己牛言']
思潮	['心早汁胃', '十心日汁胃', '十心明汁田', '心早月汁田', '十心日月汁田']
諸般	['者舟設']
増量	['埋旦曽', '一埋日曽']
胎盤	['台月皿般', '台皿股舟']
奪回	['唯因寸']
馬主	['駐']
寡占	['上且刃口穴', '上八刃口宜']
警鐘	['敬童言金']
一朝	['十土明', '十士明', '土早月', '士早月', '十土日月', '十士日月']
各紙	['氏絡']
紅色	['工絶']
鋼板	['反岡木金']
全幅	['呈大巾田', '一人呈巾田']
特訓	['川牛詩', '寺川牛言']
符合	['付答', '付口大竹', '一人付口竹']
簡保	['休口竹間', '休問日竹']
喜怒	['古奴心豆', '如心支豆', '十又如心豆', '十口奴心豆', '又古女心豆', '口女心支豆', '十又口女心豆']
寡黙	['一且刃突黒', '一且刃犬穴黒', '一八刃宜犬黒']
全量	['人旦理', '大日理', '一人日理']
哀愁	['口心秋衣']
描出	['拙苗']
諸点	['占煮言']
音韻	['暗賠']
針路	['古各止金', '十口各止金']
弔辞	['引舌辛']
音信	['位日言']
時機	['寺幾果', '寺幾日木']
体表	['俵本']
談義	['炎議']
溶媒	['安某浴', '案浴甘', '安木浴甘']
香味	['和昧', '和日未']
機具	['一八幾査', '一且八幾木']
担架	['一拐果', '拐旦木', '一拐日木']
一喜	['口土豆', '口士豆']
静的	['争勺白青']
全景	['京人旺']
泥酔	['九十尼酒']
香菜	['十木稲']
兵糧	['丘八米量']
兵舎	['丘吐火', '丘人八吐']
消炎	['淡肖']
枢機	['区幾林']
清音	['晴泣', '日泣青']
正教	['孝政']
導師	['一寸帥道']
明王	['旺月']
竜神	['申礼音']
脚部	['却月陪']
刑場	['一型易']
時季	['子寺香']
銅山	['両口金', '人呈岡', '全口岡']
農奴	['又娠曲']
粗悪	['且亜心米']
答案	['合安木竹', '口大安木竹', '一人口安木竹']
木版	['板片']
箇村	['団枯竹', '古団木竹', '古困寸竹', '固寸木竹', '十口団木竹', '十口困寸竹', '十回寸木竹']
盟友	['又日有皿']
合一	['二人口']
取捨	['人又括耳']
富国	['一回宝田']
干潮	['朝汗', '早汁肝', '十日汁肝', '十早月汗']
存命	['印合子', '印口大子', '一人印口子']
兵部	['丘八陪']
特撮	['持最牛', '取持日牛', '又持日牛耳']
香合	['人和旦', '和大日', '一人和日']
枯淡	['口木汁炎']
製鋼	['制岡衣金']
塞栓	['井全木王穴']
日英	['十央旧']
口蓋	['中十去皿']
日月	['明']
樹液	['夜村汁豆', '夜寸木汁豆']
樹海	['寸梅汁豆']
製錬	['制東衣金']
演壇	['主八回宣油', '一主回旦油穴', '主二回日油穴']
器材	['口品才木犬']
奇想	['心椅目']
古城	['十吐成']
古木	['枯']
強兵	['丘公弓虫']
軸索	['十由糸軍']
造反	['告返']
一蹴	['口就正']
計略	['十各田言']
鋼材	['岡才木金']
例会	['人伝列']
著明	['十旧月者']
内紛	['分納']
軍拡	['広揮']
検体	['倹木本', '人休合本', '人保大本', '人休口大本']
枢軸	['区木由車']
弔慰	['尉引心']
英検	['中人十大央木']
花器	['中化十品犬', '串化口古犬']
景況	['兄日涼']
東都	['者陳']
都銀	['者金限']
含意	['口念音', '吟心音', '今口心音']
高給	['不内品玄']
倒錯	['借到金']
廃案	['安床発']
別種	['刀利口重', '利力口重']
鐘楼	['女木童米金']
精錬	['東米金青']
譜例	['信列普']
蓄音	['旧畜辛', '旧玄田辛']
銅板	['反同木金']
遺失	['貴迭']
一期	['二八骨']
鋼管	['官岡竹金']
性感	['憾生']
訪朝	['早肪計', '十日肪計', '十早肪言']
保衛	['偉口桁', '偉口木行']
安直	['土女宜', '士女宜', '一十女宜']
習合	['人口百羽', '口大白羽', '一人口白羽']
時節	['即日等', '即寺日竹']
倒木	['休到']
林間	['果閑', '日木閑']
警固	['回敬計', '十回敬言']
月謝	['肘言身']
領分	['令頒']
腰部	['月要陪']
略記	['各己田言']
暗雲	['曇音']
吸盤	['又及皿船', '及口皿般']
相克	['枯見', '古木見', '兄十木目', '十口木見']
公算	['弁竹貝', '八弁目竹']
卒園	['十囚舎衣', '人十吐囚衣']
土足	['口走']
軟調	['周欠言車']
廃材	['床才発']
背部	['北月陪']
岐路	['又古各山止', '口各山支止', '十又口各山止']
腐心	['付応肉']
照度	['又庶昭', '又召庶日']
付言	['信寸']
測位	['側泣']
坂路	['反各吐止']
反吐	['口坂']
意訳	['尺心言音']
英明	['十央旧月']
会葬	['一介死芸']
姿態	['女恣能', '女心次能']
日輪	['内土旧車', '内士旧車', '一内十旧車']
立件	['位牛']
仮象	['像反']
詩吟	['今吐討', '含寺言', '今口寺言', '今吐寸言']
粗相	['査目米', '且木目米']
機軸	['幾木由車']
土台	['去口']
空路	['八口客工止', '口各工止穴']
趣意	['又恥走音', '取心走音', '又心耳走音']
兵曹	['丘八旦曲', '一丘八日曲']
季刊	['利子干']
心因	['恩']
側板	['仮則木', '休則反']
廃校	['交床発']
木彫	['周杉']
一枝	['又土木', '又士木']
合資	['員大次', '唄大次', '一人員次', '一人唄次']
専心	['寸恵']
転付	['伝寸車']
暗躍	['口曜止音', '唯日止羽音']
自慰	['尉息']
製粉	['分制米衣']
某日	['果甘']
異星	['八昔生田', '共日生田']
精舎	['人吐米青']
真性	['慎生', '十惧生']
楼閣	['各女米閑']
乾期	['乞八土早骨', '乞八士早骨', '一乙八午早骨', '一乞八十早骨', '乙八十午旦骨', '乙八午土日骨', '乙八午士日骨', '乞八十土日骨', '乞八十士日骨', '一乙八十午日骨']
超絶	['紹色走']
褒章	['依枯音', '休十哀音', '休古衣音', '休哀日辛', '位十哀果', '位古果衣', '位哀早木', '位日枯衣', '依口果辛', '依古木音', '保十衣音', '保日衣辛', '倍十果衣', '倍早木衣', '休十口衣音', '休口日衣辛', '位十口果衣', '位十哀日木', '位口早木衣', '位古日木衣', '依十口木音', '依口日木辛', '倍十日木衣', '位十口日木衣']
員数	['如敗米', '口女敗米']
苦言	['中十計']
村道	['導木']
一封	['寺王']
国守	['団宝']
思慕	['太小心日苗', '太小日田芯', '十太小心旧田']
神竜	['申礼音']
一存	['不子']
簡明	['日月竹間']
貞操	['占口損木']
落日	['各旧汁']
斜陽	['一斗易除']
時流	['一児寸法']
相反	['板目']
突堤	['旦犬穴走', '一日犬穴走']
領空	['令穴項']
掲出	['匂拙日']
言辞	['話辛']
公案	['安松']
詩作	['侍詐']
整腸	['一政易月束']
軟禁	['林欠示車']
喫緊	['又口契糸臣']
諸相	['木目者言']
胆管	['一官明竹', '官旦月竹', '一官日月竹']
諸方	['者訪']
議場	['易王義言']
婚家	['嫁日氏']
拍出	['拙白']
奇特	['埼寸牛']
埼京	['主口奇小']
強健	['仏建弓虫']
検針	['人大枯金', '人十合木金', '人古大木金', '人十口大木金']
検便	['倹梗']
謝意	['射心言音', '心討身音', '寸心言身音']
大権	['一椎矢', '一矢集']
銘記	['名己言金']
原液	['夜源']
土堤	['日王走']
褒賞	['償哀木', '償口木衣']
液中	['夜沖']
魚群	['君鮮']
工数	['女攻米']
清朝	['潮青', '十明汁青', '十晴月汁', '早月汁青', '十日月汁青']
築堤	['一凡工果竹走', '凡工旦木竹走', '一凡工日木竹走']
町議	['田義訂']
歌仙	['何可山欠']
相好	['女子木目']
託宣	['一宅旦言', '二宅日言']
一白	['百']
固辞	['十回舌辛']
脳性	['悩月生']
排撃	['手投輩', '手投車非']
番宣	['一審旦', '二審日']
悪業	['並亜心未']
加持	['寺拐']
機数	['女幾枚米']
供奉	['俸共']
鼓吹	['喜支欠', '十又喜欠', '古支欠豆', '十又古欠豆', '十口支欠豆']
消音	['日泣肖']
正攻	['工政']
清貧	['分月漬']
腕章	['宛明辛', '十宛月音', '宛日月辛']
各校	['交格']
採鉱	['拡采金']
査問	['且口閑']
性根	['恨木生']
時候	['侯寺旧']
絶交	['絞色']
擬音	['拉日疑']
法話	['去活言']
喜捨	['人古括豆', '人十口括豆']
最恵	['又恥旦由', '取心旦由', '一又恥日由', '一取心日由', '又心旦由耳', '一又心日由耳']
署員	['口者買']
特措	['持昔牛']
北朝	['十早背']
翻案	['女審木羽', '安木番羽']
楼門	['女米閑']
海草	['午旧母汁']
各藩	['番落']
可溶	['容河']
古寺	['十吐寸']
真如	['具古女', '八口女直', '具十口女', '一且八古女', '且八口土女', '且八口士女', '一且八十口女']
静態	['争心能青']
脱稿	['月税高']
中波	['沖皮']
倒立	['位到']
独尊	['寸猶虫']
薄暮	['博旧漠']
愛唱	['口日曖']
意中	['忠音']
空力	['功穴']
警笛	['敬由竹言']
巧者	['工日考']
試掘	['屈拭言']
謝辞	['射話辛', '寸話身辛', '射舌言辛', '舌討身辛', '寸舌言身辛']
呪力	['兄加']
相思	['想田', '心木田目']
官符	['付管']
薄明	['十旧浦肘', '十寸旧月浦']
貧者	['分賭']
意趣	['又恥走音', '取心走音', '又心耳走音']
警棒	['奉敬木言']
試供	['信共式', '代共工言']
中温	['日沖皿']
卑俗	['伯千谷']
暗部	['日陪音']
可搬	['又打船', '口打般']
心音	['意']
日直	['一且早', '且十旦']
腐植	['付床直肉', '値寸床肉', '土府査肉', '士府査肉', '府木直肉', '一十府査肉', '且付土床肉', '且付士床肉', '且土府木肉', '且士府木肉', '一且付十床肉', '一且十府木肉']
国富	['一回宝田']
総集	['心松維', '公心木維']
入退院	['完込限']
北壁	['口在尼辛']
話法	['去活言']
含蓄	['吟玄苗', '中今十畜', '今口玄苗', '中今十玄田']
辞意	['心舌辛音']
躍如	['口唯女止羽']
林床	['木麻']
合財	['員大才', '唄大才', '一人員才', '一人唄才']
共時	['八寺昔']
時評	['坪日討', '坪寸日言']
諦念	['今帝心言']
特等	['寸封牛竹']
翌朝	['十明羽辛', '十月章羽', '早月羽辛', '十日月羽辛']
辣腕	['宛月束辛']
口分	['八召']
染影	['九日杉涼']
法主	['去注']
管路	['口各官止竹']
供犠	['件共義', '儀共牛']
苦楽	['古薬', '十口薬']
精髄	['有迷青骨']
胎蔵	['台臓', '台月臣茂']
晩期	['免八旦骨', '一免八日骨']
腐臭	['府犬肉自']
流砂	['沙硫']
一計	['土言', '士言']
感涙	['心戻減']
記章	['己計音', '十己言音', '己日言辛']
吸蔵	['及口臣茂']
検認	['人合忍木言', '人口大忍木言']
好演	['一八女字油', '一八子安油', '一女子油穴']
低床	['休底']
胴部	['同月陪']
八景	['六口小日']
兵装	['丘八壮衣']
箇寺	['固等', '十回等', '十吐団竹']
作詩	['侍詐']
真情	['慎青', '十惧青']
精機	['幾木米青']
竹馬	['篤']
直言	['一且計']
怒張	['奴弓心長', '又女弓心長']
棒鋼	['奉岡木金']
連銀	['車退金']
休診	['人信杉']
始期	['一公如骨', '一八台女骨', '一公口女骨']
諸悪	['亜心者言']
調伏	['信周犬']
機影	['幾景杉', '京幾日杉']
原潜	['替源']
体言	['信本']
大寒	['一丼太穴']
標記	['己木票言']
方陣	['車防']
妙技	['十奴抄', '女抄支', '十又女抄']
銘板	['反名木金']
悪路	['亜口各心止']
恵日	['心旦由']
概数	['女既枚米']
全回	['呈囚']
調略	['各周田言']
日支	['又早']
流音	['充旧泣']
閑古	['十問木']
記数	['女改米言']
愚連	['心車遇']
検校	['交人合林', '交人口大林']
紙幅	['一口巾氏細']
諸姉	['一女巾者言']
新論	['一内薪言']
窃取	['切又穴耳']
打設	['投訂']
調儀	['信周義']
春宮	['呂実日']
動体	['働本']
異株	['共木朱田']
訓導	['川討道', '寸川言道']
鋼製	['制岡衣金']
最落	['取各旧汁', '又各旧汁耳']
呪法	['去口況']
粗製	['且制米衣']
恥部	['心耳陪']
超克	['兄十召走']
抱合	['包拾']
黙想	['心犬相黒', '心木犬目黒']
暗闘	['寸日豆闇', '寸豆間音']
引導	['寸弔道']
滑空	['江穴骨']
研削	['刑硝']
体動	['働本']
等量	['埋寸旦竹', '一埋寸日竹']
本例	['体列']
木管	['棺竹']
里程	['和理']
液胞	['夜月泡']
箇日	['回早竹']
盛装	['壮成皿衣']
精兵	['丘八米青']
特恵	['一寺心牛由', '寸心牛王由']
卑小	['十少白']
標章	['果票辛', '十木票音', '日木票辛', '一中旧木示辛']
油膜	['月漠由']
悪辣	['亜心束辛']
滑膜	['月漠骨']
幹校	['交人十干早木']
眼病	['丙痕目']
休載	['伐十木車']
公信	['仏八言']
鼓笛	['十支由竹豆']
謝恩	['因射心言', '因心討身', '因寸心言身']
全機	['幾栓']
全訳	['尺詮']
総収	['公又心糾']
日章	['十暗', '早音']
林木	['森']
悪習	['亜心白羽']
暁星	['元千日旧生']
作意	['位心昨']
全相	['栓目']
同金	['銅']
休講	['信構', '井信再木']
供試	['信共式', '代共工言']
献体	['伏南本']
整枝	['支政木束', '十又政木束']
俗論	['倫言谷']
幕舎	['人口墓巾']
閉校	['交才閑']
各級	['及絡']
各室	['客至']
好悪	['亜女子心']
詩型	['刑封言']
促音	['位日足']
導引	['寸弔道']
付会	['人伝寸']
分合	['一召火', '八召大', '一人八召']
名鑑	['監銘']
暗譜	['日普言音']
果菜	['菓采']
記銘	['名己言金']
好古	['十如子', '十口女子']
枯木	['古林', '十口林']
軟部	['欠車陪']
悲喜	['古心豆非', '十口心豆非']
保因	['休咽']
路盤	['又各止皿船', '口各止皿般']
育休	['一仏月木']
給田	['合細', '口大細', '一人口細']
苦味	['中十古未']
献辞	['南犬舌辛']
製版	['制反片衣']
腸壁	['十培戸易月', '吐戸易月辛']
痴話	['口疾舌言']
俳壇	['主但回非']
香具師	['一八帥旦租', '二八帥日租']
異記	['共己田言']
一樹	['土村豆', '士村豆', '土寸木豆', '士寸木豆']
架構	['井再加林']
禁教	['孝木枚示']
車速	['束連']
章句	['口旬辛']
神幸	['平申社']
装花	['化荘衣']
長姉	['一女帳']
銅器	['口同品犬金']
如是	['女旦足', '一女日足']
詠歌	['可吹永訂', '口可欠永訂']
休会	['人伝木']
校章	['交果辛', '交十木音', '交日木辛']
公租	['且八私']
室数	['安米致']
支保	['伎口木', '休又古', '休十又口']
縮合	['宿給']
呪具	['且八口西', '一且兄八口']
粗鋼	['且岡米金']
朝報	['十幸早服']
特赦	['寺牧赤']
倍量	['但口童']
付票	['価寸示']
分速	['八束辺']
塩乾	['乞午吐早皿', '乞十午吐日皿']
仮構	['井休再反']
兄姉	['女巾西']
検案	['人合安林', '人口大安林']
済度	['斉渡']
市町村議	['寸柿田義訂', '寺巾我木田立訂']
臭味	['嗅未', '口未犬自']
樹間	['十果闘', '早木闘', '十日木闘', '寸早豆閑', '十寸日豆閑']
盛期	['一八成皿骨']
線的	['泉白約']
直筋	['助土月竹', '助士月竹', '一助十月竹']
転借	['伝昔車']
半休	['伴木']
仏寺	['付去']
木棺	['官林']
略取	['又各田耳']
異体	['供本田']
各線	['泉絡']
活着	['洋目舌']
宮女	['呂安']
禁門	['木示閑']
古相	['枯目', '十口木目']
合力	['加大', '一人加']
食洗	['人先浪']
諸子	['孝日言']
諸式	['者試']
精読	['売米請', '売米言青']
町誌	['志田訂']
嘲弄	['中千土旺月', '中千士旺月', '千呈土旧月', '千呈士旧月', '一中十千旺月', '一十千呈旧月']
特掲	['匂持日牛']
軟鋼	['岡欠車金']
黙読	['売犬言黒']
立米	['粒']
一等	['寸王竹']
窮奇	['八寄弓身']
勤倹	['人僅加大']
激特	['坊寸泊牧', '寺放泊牛']
公休	['仏八木']
鋼線	['泉綱金']
射的	['勺寸白身']
主格	['各柱']
忠信	['仲心言']
銅版	['反同片金']
哀調	['口周衣言']
雅叙	['余牙隻']
漁期	['一八滑魚']
載荷	['伐十苛車']
財別	['刀則口才', '則力口才']
諸賢	['又臣言賭']
畜舎	['人吐玄田']
衷心	['忠衣']
鎮定	['真錠', '八直錠', '具十錠', '且八土錠', '且八士錠', '一且八十錠']
同源	['原洞']
排仏	['俳払']
付議	['儀討', '信寸義', '儀寸言']
溶着	['容洋目']
閑吟	['今問木']
群読	['君売詳']
原藻	['串枯源', '中口枯源', '串古木源', '中口古木源', '串十口木源']
試射	['式謝', '式討身', '寸式言身']
詩神	['申社討', '寸申社言']
専一	['二寸由']
全的	['人勺皇']
鎮台	['公口直金', '一且公口針', '一且公古金', '且公口土金', '且公口士金', '一且公十口金']
特認	['忍牛詩', '寺忍牛言']
胴長	['同脹']
日比	['昆']
筆法	['去津竹']
異相	['共木田目']
債主	['住責']
斜塔	['二斗舎茶', '合斗王茶', '一吐大斗茶', '二人吐斗茶', '口大斗王茶', '一人口斗王茶', '中人余十斗王']
常侍	['付堂巾']
相聞	['目耳閑']
朝議	['十明義計', '早月義計', '十日月義計', '十早月義言']
等方	['坊寸竹']
薄給	['中大汁縛', '一中人汁縛']
悲田	['思非']
葉姿	['世女木茨']
活魚	['漁舌']
謹賀	['勤員言', '勤唄言']
訓辞	['川話辛', '川舌言辛']
採苗	['描采']
諸公	['者訟']
搬器	['口品投犬舟']
表側	['俵則']
兵村	['丘八寸木']
空撮	['控最', '取控日', '又控日耳']
警保	['休口敬言', '信口敬木', '中信十句枚']
幸甚	['堪平']
古鏡	['兄章金', '兄針音', '克金音', '兄十金音', '兄日辛金']
製糖	['制唐米衣']
専担	['一寸抽旦', '二寸抽日']
全村	['寸栓']
早生	['十星']
側枝	['伎則木', '休則支', '休則十又']
潮音	['日朝泣', '明汁章', '十早明泣', '十暗月汁', '日明汁辛', '日月汁章', '十日早月泣']
晩生	['免星']
払底	['広抵']
浮標	['子漂采']
別科	['刀利口斗', '利力口斗']
肝胆	['一干明月']
乾板	['乙十午反果', '乙午反早木', '乞十反早木', '乙十午反日木']
乾物	['乙十午易牛']
検収	['人又叫大木']
鯨油	['京漁由', '涼由魚']
古流	['中充汁']
左肺	['一工巾有', '一工布月']
詩壇	['一主回時言', '主吐団旦言', '主回寺旦言', '主回日王討', '一主吐団日言', '一主回寺日言', '主口団日王言', '主回寸日王言']
諸部	['者言陪']
線内	['泉納']
膳部	['善月陪']
早暁	['元十千日旧']
粗略	['且各田米']
帝紀	['己締']
動点	['勲占']
晩鐘	['免日童金']
付款	['仕寸欠示']
粉炭	['分山灰米']
翻意	['心日番翌', '心番羽音', '必日田米翌', '必日田粒羽', '必田米羽音']
欲界	['介欠田谷']
両藩	['満番']
林学	['子木栄']
話例	['信列舌']
演台	['一八宙治', '一治由穴']
改植	['己枚直', '且土己枚', '且士己枚', '一且十己枚']
各機	['幾格']
可採	['口打采']
架装	['加壮木衣']
古今	['十吟', '十含']
古兵	['丘八十口']
社歴	['圧林祉']
装弾	['単壮弓衣']
抽台	['口払由']
弔意	['引心音']
特指	['持旨牛']
特装	['壮寺牛衣']
動学	['労子重']
銅製	['制同衣金']
壁量	['一埋居音', '口埋戸章', '古埋戸音', '吐戸早童', '居日王童', '十口埋戸音', '十吐戸日童', '口埋戸日辛']
麻黄	['床横']
木柵	['冊林']
利殖	['列土租', '列士租', '一列十租']
各村	['寸格']
河谷	['可浴']
魚油	['漁由']
吟詠	['含永言', '今口永言']
具格	['一八各査', '一且八各木']
検潮	['人十大果湖', '人大早木湖', '人大明枯汁', '人十合明木汁', '人十合月果汁', '人十大日木湖', '人古大明木汁', '人古大月果汁', '人合早月木汁', '人大日月枯汁', '人十口大明木汁', '人十口大月果汁', '人十合日月木汁', '人口大早月木汁', '人古大日月木汁', '人十口大日月木汁']
構法	['去木溝']
交絡	['各絞']
集材	['才木椎']
珠算	['弄朱目竹']
時習	['寺日白羽']
聖心	['呈恥']
先回	['告四']
仙翁	['仏八山羽']
祖型	['且刑社']
隊舎	['人口墜']
覆輪	['中人冊土復車', '中人冊士復車', '中冊十大復車', '一中人冊十復車']
妄念	['今女忘']
暗合	['人口旦音', '口大日音', '一人口日音']
仮植	['値板', '休反直', '値反木', '且休反土', '且休反士', '一且休十反']
歌論	['一内吹苛訂', '人同欠苛訂', '一内口欠苛訂', '一内可欠苛言', '中内可土欠訂', '中内可士欠訂', '一中内十可欠訂']
肝油	['月汗由']
合葬	['一中介土死', '一中介士死', '中二介十死']
景物	['京易牛']
個的	['伯勺固', '伯勺十回']
固溶	['回容汁']
詩想	['寺心相言', '寺心木目言']
儒林	['休木需']
聖具	['一且八呈耳']
東院	['完陳']
突合	['口大犬穴', '一人口犬穴']
付論	['倫討', '倫寸言']
法談	['去淡言']
藍藻	['串木濫苦', '中口木濫苦', '中串十木汁監']
暗紫	['旨止糸音']
黄桃	['兆横']
勘合	['加大甚', '一人加甚']
月日	['明']
機業	['並幾木未']
校合	['交口大木', '一交人口木']
苦界	['介古苗', '中人千苗', '介十口苗']
恵沢	['一尺心油']
講壇	['主井再回旦言', '主再口囲旦言', '一主井再回日言', '一主再口囲日言']
公路	['口唆止', '八台各止']
婚期	['八女旦氏骨', '一八女日氏骨']
合科	['和大斗', '一人和斗']
錯体	['借鉢', '借本金']
山体	['仙本']
詞章	['司計音', '十司言音', '司日言辛']
射幸	['寺平身']
主機	['幾柱']
侍中	['仲寺']
盛時	['城寸日皿', '寺成日皿']
千古	['十舌']
草姿	['女早茨', '十女日茨']
痴態	['口心疾能']
糖業	['並唐未米']
温感	['心日減皿']
各案	['安格', '女客木']
滑舌	['活骨']
脇息	['心脅自']
警職	['敬耳識']
月界	['介胃']
原詩	['圧小白討', '圧寸小白言']
香具	['八旦租', '一八日租']
好守	['女字寸', '子安寸']
稿料	['科米高']
己心	['忌']
諸器	['口品犬者言']
植字	['土子宜木', '士子宜木', '一十子宜木']
諸寺	['者詩']
新著	['者薪']
情意	['憶青']
正調	['周証']
増槽	['曲曽果王', '日曲曽木王']
大扉	['戻非']
暖機	['友幾旦采', '一友幾日采']
点者	['占煮']
特保	['件吐村', '付吐木牛', '件口寺木', '件吐寸木', '休口寺牛', '休吐寸牛', '侍口木牛']
同治	['台洞']
農漁村	['寸木濃魚']
俳誌	['仕悲言', '信志非', '仕心言非']
白河	['可泊']
略字	['子客田']
楼主	['女柱米']
可倒	['何到']
器壁	['品培居犬']
検眼	['人合根目', '人口大根目']
検算	['一介合箱', '一介相答', '一介口大箱', '一介合相竹', '一介木目答', '二人介口箱', '一介口大相竹', '一介合木目竹', '二人介口相竹', '一介口大木目竹', '二人介口木目竹']
公器	['八台品犬']
古詩	['十吐討', '口寺計', '吐寸計', '十口寺言', '十吐寸言']
古湯	['一口易汁']
集古	['十口椎', '十唯木']
主材	['才柱']
触腕	['宛月虫角']
銃眼	['充目銀']
重積	['種責']
装荷	['何荘衣', '依可荘', '依壮苛']
措辞	['括昔辛', '十拉昔舌']
蔵版	['反片臣茂']
炭材	['山才木灰']
答辞	['合竹舌辛', '口大竹舌辛', '一人口竹舌辛']
農漁業	['並未濃魚']
廃村	['寸床発']
別稿	['刀利口高', '利力口高']
歩測	['則渉', '則止沙']
妙香	['女日秒']
約分	['勺紛']
葉幅	['一世口巾木苗', '世中土巾木田', '世中士巾木田', '一世中十巾木田']
要論	['中冊大女計', '一中人冊女計', '中人冊土女言', '中人冊士女言', '中冊十大女言', '一中人冊十女言']
竜舌	['乱音']
涼感	['京心減']
暦学	['厚木栄']
悪趣	['亜又恥走', '亜取心走', '亜又心耳走']
胃管	['官月田竹']
海幕	['巾旧母汁矢']
各員	['口賂']
花心	['化芯']
学林	['子木栄']
玩味	['元呈未']
金枝	['又木針']
苦吟	['中今十古']
元宵	['完肖']
香煙	['中旧王秋']
好著	['十女孝旧']
左傾	['佐頃']
山砲	['包岩']
祝着	['兄目祥', '口祥見']
呪符	['付兄口竹']
接舷	['女拉玄舟']
専検	['合大村由', '一人合村由', '合大寸木由', '一人口大村由', '一人合寸木由', '一人口大寸木由']
仙桃	['休兆山']
是空	['八定工日']
怠業	['並台心未']
弔詞	['司引言']
超訳	['尺詔走', '召尺言走']
等軸	['寺笛車', '寺由竹車']
東麓	['木棟鹿']
同節	['即筒']
肺内	['丙巾月']
八字	['子穴']
反覆	['中又復斤']
反例	['仮列']
訪花	['化芳言']
松科	['八斗木私']
明哲	['口折日月']
陽根	['一易木限']
林相	['森目']
楽壇	['八吐困日白立']
経筋	['又在幼月竹']
計時	['早詩', '十日詩', '寺早言', '十寺日言']
計帳	['十巾言長']
校異	['交共木田']
口輪	['中内土車', '中内士車', '一中内十車']
色紙	['氏絶']
真景	['京具早', '京八日直', '京具十日', '一且京八早', '且京八十旦', '且京八土日', '且京八士日', '且六古小旦', '六口小日直', '一且京八十日', '一且六口小早', '一且六古小日', '且六十口小旦', '且六口土小日', '且六口士小日', '一且六十口小日']
次姉	['一姿巾']
呪的	['兄勺口白']
晴嵐	['山日青風']
専管	['一官寸笛', '一官寸由竹']
仙椎	['催木']
跳弾	['兆単口弓止']
直管	['且土官竹', '且士官竹', '一且十官竹']
特機	['寺幾木牛']
藩論	['人冊汁番計', '人冊十汁番言', '人冊千汁田米言']
本俸	['体奉']
某市	['柿甘']
明認	['忍日月言']
良法	['去浪']
輪読	['売論車']
哀話	['口舌衣言']
一尉	['寸戸示']
一曹	['二日曲']
右葉	['世木若']
寡兵	['丘具刃穴', '一且丘八刃穴']
器種	['和品犬重']
脚韻	['却明賠', '却員月音', '却唄月音', '却日月賠']
見神	['申視']
公舎	['去口火', '人八去口']
肯認	['忍月止言']
支場	['十又易王']
斜路	['余口各斗止', '口合斗条止']
鐘塔	['中人王童針', '中埋大辛金', '一中人埋辛金', '中人十王童金']
神札	['木申礼']
自益	['八皿首']
直談	['一且炎計', '且土炎言', '且士炎言', '一且十炎言']
辞儀	['位十義舌']
時鐘	['埋寸金音', '寺日童金']
時相	['寺果目', '寺日木目']
樹枝	['寸林鼓', '木村鼓', '十寸支林豆', '十支木村豆']
節間	['即簡']
相加	['架目']
築庭	['凡工床廷竹']
点列	['占烈']
如己	['口妃']
人皇	['全白']
標目	['相票']
病根	['柄痕', '丙木痕']
余花	['一化茶']
翌晩	['免羽音']
輪唱	['中内旦早車', '人同旧早車', '内古旦旧車', '一中内日早車', '一内口旧早車', '一内古日旧車', '中内十日旦車', '人十同日旧車', '内十口旦旧車', '内口土日旧車', '内口士日旧車', '一内十口日旧車']
暗幕	['巾暮音']
右腕	['口宛有']
液膜	['夜月漠']
演唱	['口日旦油穴']
各棟	['東格']
核力	['劾木']
仮言	['信反']
機略	['人格畿', '幾格田', '人各木畿', '各幾木田']
偽計	['信十為']
口針	['古金']
紅粉	['工米紛']
古期	['八口土骨', '八口士骨', '一八十口骨']
古銅	['口同針', '十口同金']
祭室	['察至']
詐偽	['作為言']
詩節	['即等言', '即寺竹言']
脂粉	['分旨月米']
捨受	['人授舌']
集線	['木泉維']
招喚	['口召換']
諸郡	['君言都']
信賞	['償言']
軸部	['由車陪']
呪医	['匹口知']
浄妙	['争女沙']
叙景	['京余又日']
全話	['舌詮']
相銀	['木眼金', '根目金']
測度	['則渡']
村数	['女寸枚米']
中体	['仲本']
調弦	['周弓玄言']
艇庫	['庭舟車']
等時	['寸封日竹']
同温	['日洞皿']
日計	['早言']
標数	['女枚票米', '枚示米要']
伏鉢	['体犬金']
閉架	['加才閑']
北湖	['口汁背']
某女	['媒']
盆略	['分各田皿']
門楼	['女米閑']
乱麻	['床札舌']
異業	['並共未田']
異装	['共壮田衣']
科別	['刀利口斗', '利力口斗']
鑑査	['且木監金']
鏡検	['人兄大木金音']
金的	['白釣']
空腸	['一工易月穴']
空胞	['包工月穴']
計装	['十壮衣言']
古音	['口章', '口日辛']
混植	['一昆査汁', '旦査比汁', '一且昆木汁', '一且果比汁', '一日査比汁', '且旦木比汁', '一且日木比汁']
擦式	['察拭']
試打	['拭訂']
取集	['又椎耳', '木耳隻']
章程	['呈辛香', '和旺辛']
真俗	['値八谷']
集諦	['帝木誰', '帝椎言']
城市	['主巾成']
正数	['女政米']
相合	['口大木目', '一人口木目']
双樹	['又寸枝豆', '又支村豆', '又寸支木豆']
増反	['坂曽']
鎮兵	['丘八具針', '丘八真金', '丘八具十金']
堤体	['但本走']
等張	['寺弓竹長']
土公	['八去']
日王	['旺']
背銘	['北名月金']
反側	['仮則']
版築	['凡工板片竹', '凡反工木片竹']
売約	['勺続']
法意	['去心日泣']
封神	['寺申社']
味読	['口売未言']
迷言	['謎']
余得	['寸徐旦', '一寸徐日']
略論	['一内各苗言']
路村	['口寸格止', '口各寸木止']
悪因	['亜恩']
異時	['八寺昔田', '共寺日田']
右隻	['友唯']
英艦	['央舟藍']
憶説	['悦意言', '心悦言音']
改貨	['化己敗']
界線	['介泉細']
皆兵	['丘八比白']
頑是	['元題']
貴僧	['一仲贈']
吸排	['口扱非']
控股	['投月空', '工投月穴']
苦諦	['中十帝計']
激音	['放日泣白']
鋼業	['並岡未金']
交線	['泉絞']
鋼船	['岡舟鉛']
公調委	['八周女私言']
骨法	['去滑']
個票	['価固示', '価十回示']
鼓楼	['十女枝米豆', '十女支木米豆']
集信	['休誰']
主馬	['駐']
春宵	['実日肖']
荘田	['壮苗']
掌帆	['凡常手']
職組	['且織耳']
真諦	['具帝計', '八帝直言', '具十帝言', '一且八帝計', '且八土帝言', '且八士帝言', '一且八十帝言']
軸装	['壮由衣車']
侍講	['井信再寺']
持碁	['基寸拓']
持仏	['侍払']
樹体	['付十木本豆', '休十寸本豆']
叙階	['又皆除', '又比白除']
時論	['内土旧詩', '内士旧詩', '一内十旧詩', '一内寺旧計', '内十旧王討', '内土寺旧言', '内士寺旧言', '内寸旧王計', '一内十寺旧言', '内十寸旧王言']
倉皇	['人口戸玉白']
装薬	['楽荘衣']
側転	['伝則車']
存城	['在子成']
炭粉	['分山灰米']
大姉	['天女巾']
諾成	['若誠']
腸液	['夜月湯']
調速	['束言週']
停会	['亭人伝']
銅管	['官筒金', '同官竹金']
背斜	['余北斗月']
薄暑	['寸日浦著', '十寸旧浦者']
博捜	['寸捕支申', '十又寸捕申']
別章	['刀剖早', '剖力早', '刀剖十日', '剖力十日']
訪英	['央芳言']
棒銀	['奉根金']
牧柵	['冊枚牛']
異心	['共思']
詠草	['十旧永計']
可換	['喚打']
仮訳	['信反尺']
官等	['寺管']
機巧	['工幾朽']
忌中	['己忠']
検鏡	['人兄大木金音']
月旦	['胆', '一明']
公議	['義訟']
校訓	['交川木言']
紅帝	['工締']
古法	['去口汁']
合築	['凡工木答', '凡口大工木竹', '一人凡口工木竹']
合有	['右大月', '一人右月']
最左	['友工日耳']
裁例	['伐十裂', '伐列十衣']
詩韻	['時言賠', '員寺言音', '唄寺言音', '寺日言賠']
試演	['一式油穴言']
詩鐘	['寺童言金']
集禁	['林椎示']
守兵	['丘寸穴']
食法	['人去浪']
諸章	['暑言辛', '者計音', '十者言音', '日者言辛']
心耳	['恥']
直話	['一且舌計', '且土舌言', '且士舌言', '一且十舌言']
侍童	['位埋寸']
銃兵	['丘充八金']
樹姿	['十女村次豆', '十女寸木次豆']
場景	['京日易王', '主口小旦易', '一主口小日易']
侍立	['位寺']
吹部	['口欠陪']
聖塔	['中全古王耳', '中全吐土耳', '中全吐士耳', '串全十王耳', '一中全十吐耳', '中人十呈王耳', '中全十口王耳']
清白	['泊青']
潜竜	['替滝']
装輪	['一内荘衣車']
男権	['勧木田']
調息	['周心自言']
同胎	['台胴']
乳棒	['奉孔采']
粘板	['占反木米']
博品	['口古哺寸']
悲話	['心舌言非']
壁厚	['圧子居音']
膜法	['去月漠']
明珠	['旺月朱']
欲棒	['奉木欠谷']
輪講	['井再論車']
林住	['休柱']
臨模	['串古果矢臣', '串日枯矢臣', '中口古果矢臣', '中口日枯矢臣', '串十口果矢臣', '串口早木矢臣', '串古日木矢臣', '十品旧木矢臣', '中口古日木矢臣', '串十口日木矢臣']
類歌	['可吹犬米頂', '口可欠犬米頂']
例話	['信列舌']
話材	['才木舌言']
温習	['日泊皿羽']
歌誌	['可吹志訂', '口可志欠訂', '可吉心欠訂']
架蔵	['加木臣茂']
寡夫	['一分失宜']
感温	['心日減皿']
外合	['下人名']
概査	['且既林']
街村	['封桁', '封木行']
眼鏡	['見銀音']
吉例	['仕列口']
吸息	['及口心自']
教相	['孝枚目']
義認	['忍議']
空技	['控支', '十又控']
検数	['人合女枚米', '人大如枚米', '人口大女枚米']
鉱場	['広易王金']
坑木	['主机']
古格	['各枯', '十口各木']
最右	['友口日耳']
師管	['一官帥竹']
詩章	['寺計音', '時言辛', '十寺言音', '寺日言辛']
始審	['台安番']
詩聖	['呈寺耳言']
市村	['寸柿']
射場	['一寺易身', '寸易王身']
集排	['推木非']
主枝	['支柱', '十又柱']
諸侍	['信寺者']
真棒	['八奉植', '八土奉査', '八士奉査', '八奉木直', '具十奉木', '一八十奉査', '且八土奉木', '且八士奉木', '一且八十奉木']
軸棒	['奉木由車']
十哲	['古折']
呪師	['口帥西', '一兄口帥']
青染	['九木清']
聖誕	['呈延耳言']
青楼	['女木精']
相等	['寺箱', '寺木目竹']
淡青	['清炎']
直路	['且古各正', '一且古各止', '且十口各正', '且口各土止', '且口各士止', '一且十口各止']
堤内	['丙日走']
東校	['交棟']
東郊	['交陳']
特曹	['一時曲牛', '寺旦曲牛', '一寺日曲牛', '寸日曲牛王']
特損	['員持牛', '唄持牛']
二曹	['三日曲']
乳葉	['世孔菜']
俳譜	['信普非']
俳論	['倫言非']
蛮夏	['一変自虫']
粉青	['分精']
分線	['泉紛']
浴客	['各溶']
余論	['二内茶言']
暗期	['八旦音骨', '一八日音骨']
囲口	['井回']
意業	['並心未音']
遺詔	['口言貴辺']
押韻	['損甲音', '員拉日甲', '唄拉日甲']
各財	['才賂']
火田	['畑']
寒水	['一丼氷穴']
苦況	['中克汁', '中兄十汁']
月台	['胎']
公企体	['仏本止火', '人仏八本止']
講究	['九井再穴言']
講式	['井再試']
古態	['十口心能']
古刀	['十召']
古塔	['一舎苦', '吐大苦', '一人吐苦', '中十土舎', '中十士舎', '人口王苦', '中人十吐土', '中人十吐士']
採暖	['援日采']
催吐	['仙口堆']
左腎	['又工有臣', '友工月臣']
詩業	['並寺未言']
紙工	['氏紅']
支合	['又古大', '一人又古', '人又口土', '人又口士', '十又口大', '一人十又口']
詩仙	['侍山言', '信寺山']
射弾	['単寸弓身']
主潮	['朝注', '十早月注']
消磁	['滋硝']
諸司	['者詞']
諸村	['木者討', '寸木者言']
信士	['仕言']
軸距	['口巨止由車']
邪眼	['牙目限']
腎精	['又月米臣青']
人皇	['全白']
寸言	['討']
寸松	['公村']
精管	['官竹米青']
腺管	['官月泉竹']
村議	['木義討', '寸木義言']
増倍	['位吐曽']
俗臭	['伏自谷']
畜力	['玄男']
長腕	['宛脹']
等値	['侍直竹', '且侍土竹', '且侍士竹', '且十王符', '一且侍十竹', '且付十王竹']
読師	['一売帥言']
内約	['勺納']
半側	['伴則']
非心	['悲']
付載	['伐十寸車']
不味	['否未']
兵談	['丘八炎言']
兵略	['丘八各田']
遺告	['貴造']
略案	['安格田', '各安木田', '女客木田']
量程	['和旦理', '一口理香', '一和日理']
累加	['口男糸', '口小幼田']
楼台	['始木米']
路程	['各呈和止']
悪婆	['亜女心波']
異姓	['共女生田']
温菜	['旧汁皿采']
回章	['固音']
閣員	['問賂']
活計	['汁話', '汁舌言']
可読	['口売訂']
韓紙	['十早氏緯']
雅趣	['牙耳走隻']
雅味	['唯未牙']
脚台	['却胎']
旧路	['中各日止']
教案	['孝安枚']
金鼓	['支豆針', '十又豆針']
苦汗	['中十干汁']
群泳	['君永洋']
契合	['喫大', '一人喫']
原土	['圧小白']
洪範	['共氾竹車']
古訓	['口川計', '十口川言']
混配	['己昆酒', '己日比酒']
祭宴	['女察日']
最特	['取時牛', '又時牛耳', '取寺日牛', '又寺日牛耳']
試技	['又拭計', '拭支言', '十又拭言']
詩思	['寺心田言']
詞藻	['串口司木汁言']
射映	['央寸日身']
秋思	['愁田']
春窮	['八実弓日身']
春蚕	['奏日虫']
春天	['奏日']
諸案	['安木者言']
相公	['松目']
諸例	['信列者']
針広	['十鉱']
真信	['値八言']
神呪	['口申祝']
治工具	['一且八台江', '一且公口江']
示寂	['叔宗']
重筋	['動月竹']
女唇	['口娠']
寸借	['付昔']
聖訓	['呈川耳言']
精検	['人合木米青', '人口大木米青']
精汁	['十清米']
清談	['淡請', '淡言青']
洗腸	['先月湯']
染筆	['九木津竹']
前照	['昭煎', '召日煎']
曹兵	['丘八旦曲', '一丘八日曲']
粗銅	['且同米金']
損出	['員拙', '唄拙']
増兵	['丘塁日']
鍛接	['女拉段金']
値域	['一伐吐直', '伐口王直', '一且伐古王', '一且伐吐土', '一且伐吐士', '且二伐十吐', '且伐口土王', '且伐口士王', '一且伐十口王']
弔鐘	['引童金']
超勝	['券加月走']
調進	['誰週']
町村議	['寸木田義訂']
泥中	['尼沖']
桃林	['兆森']
同鉱	['広銅']
土量	['埋旦', '一埋日']
内合	['丙人口']
南人	['内十平']
念持	['寺捻']
濃青	['清農']
倍旧	['中位日']
晩節	['免即日竹']
品番	['口呂田米']
白法	['去泊']
副室	['到富']
伏射	['付犬身']
奉体	['俸本']
魔味	['口魅麻', '口床木魅']
薬方	['楽芳']
欲念	['今心欠谷']
翼板	['反木異羽', '共反木田羽']
翼幅	['一口巾田異羽']
翼部	['異羽陪', '共田羽陪']
話柄	['丙木舌言']
悪謀	['亜心某言', '亜心木甘言']
意符	['億寸竹', '付心竹音', '位寸心日竹']
英姿	['央女茨']
英日	['十央旧']
黄麻	['床横']
温容	['日溶皿']
歌詩	['可吹寺訂', '口可寺欠訂', '可吐寸欠訂']
渇筆	['匂日津竹']
花論	['人冊化十計']
器財	['品員才犬', '品唄才犬']
器体	['伏口品本']
吸管	['及口官竹']
旧口	['中日']
共唱	['八口日昔']
逆潮	['早汁遡', '十日汁遡']
空谷	['八容工']
区検	['人合枢', '人口大枢']
掲句	['匂拘日']
軽合	['一又舎車', '又吐大車', '一人又吐車', '人又口王車']
傾動	['働頃']
県市	['亡小巾目']
言者	['諸']
口囲	['井回']
鼓腸	['土易肢豆', '士易肢豆', '一十易肢豆', '土支易月豆', '士支易月豆', '一十支易月豆', '十又土易月豆', '十又士易月豆']
語性	['悟生言']
査読	['且売木言']
車交	['較']
周速	['束週']
集村	['寸木椎']
衝激	['放泊行重']
鐘鼓	['支童豆針', '十又童豆針', '十支童豆金']
章節	['十即竹音', '即日竹辛']
職訓	['川耳識']
食治	['人台浪']
諸版	['反片者言']
真個	['値八固', '値八十回']
真神	['八土申祖', '八士申祖', '一八十申祖']
真字	['子直穴', '且土子穴', '且士子穴', '八土子宜', '八士子宜', '一且十子穴', '一八十子宜']
侍衛	['偉寺行']
直納	['丙十組']
寺塔	['中人土封', '中人士封', '中十大封', '一中人十封']
腎管	['又官月竹臣']
腎節	['即又月竹臣']
製靴	['制化衣革']
正言	['証']
精好	['女子米青']
静思	['争心田青']
生時	['寺星']
整版	['反政束片']
精母	['月毒米']
専恣	['寸恵次', '一寸心次由']
栓塞	['井全木王穴']
全習	['人皇羽']
藻床	['串口汁麻']
曹時	['寺日旦曲']
側音	['位則日']
造精	['告迷青']
増台	['去口曽']
胎土	['去口月']
体半	['伴本']
旦暮	['天日旧早']
痴女	['口嫉', '如疾']
宙尉	['守届示', '宗寸届']
腸毒	['一易母青']
朝幕	['十巾早膜']
超錬	['召東走金']
直員	['且唄土', '且唄士', '一且十唄']
定線	['泉綻']
低部	['倍邸', '位口邸']
篤敬	['竹驚']
動植	['助土木重', '助士木重', '一助十木重']
銅人	['一内口金']
銅棒	['同奉木金']
土祝	['兄社']
土神	['申社']
土壇	['主回日王']
軟腐	['付庫欠肉', '府欠肉車']
白泥	['尼泊']
破擦	['察拓皮']
反俗	['仮谷']
爆燃	['暴炎然']
非想	['悲相', '悲木目']
筆洗	['先津竹']
平調	['周評']
標治	['台木漂']
付章	['位寸早', '位十寸日']
分給	['合紛', '一火紹', '八大紹', '口大紛', '一人八紹', '一人口紛']
仏真	['値公']
閉村	['寸才閑']
別辞	['刀剖十舌', '剖力十舌']
法音	['去日泣']
謀攻	['工枚甘言']
脈波	['月派皮']
明期	['八胆骨', '八旦月骨', '一八日月骨']
明報	['幸日服']
明要	['日腰', '一中女旧月']
木栓	['全林']
溶骨	['容滑']
溶食	['人容浪']
略帽	['冒各巾田']
林材	['才森']
輪部	['一中内辛陣']
例言	['信列']
論著	['人冊十者計']
哀韻	['口員衣音', '口唄衣音', '口日衣賠']
悪相	['亜想', '亜心木目']
安摩	['床手案']
遺習	['羽貴迫']
異日	['八昔田']
異樹	['共十村田豆', '共十寸木田豆']
遺精	['貴迷青']
会苦	['人古芸', '人十口芸']
演員	['一唄油穴']
演鑑	['一八宙濫金', '一油監穴金', '一濫由穴金']
音価	['一中位旧']
温良	['日浪皿']
改案	['安己枚']
皆済	['斉比泊']
解呪	['兄召牛角']
解兵	['丘分牛角']
拡材	['床才払']
各宗	['客示']
寡人	['一刃宜火', '且刃大穴', '八刃大宜']
歌題	['可吹是頂', '口可是欠頂', '可旦欠足頂', '一可日欠足頂']
箇町村	['十可団木田竹', '十可困寸田竹']
歌俳	['何可欠非']
幹囲	['井十囚干早']
幹音	['人干早章', '人十干日章', '人干日早辛']
款状	['壮欠犬示']
間税	['閲香']
概計	['十既木言']
玩器	['元呈品犬']
機帆	['凡巾幾木']
吸力	['加及']
筋束	['勅月竹']
偽誓	['信折為']
空格	['八客工木', '各工木穴']
空相	['工木目穴']
苦果	['古菓', '十口菓']
苦海	['中午母汁']
警正	['敬証']
激苦	['故泊芳', '中十放汁白']
激臭	['放泊犬自']
口乾	['乞古早', '乙午古日', '乞十古日']
講時	['井再日詩', '井再寺日言']
工順	['川項']
好生	['姓子']
工販	['反貢']
公保	['休八台', '仏八口木']
鼓音	['支章豆', '十又章豆', '又早豆辛', '支日豆辛', '十又日豆辛']
古雅	['十唯牙']
古記	['口己計', '十口己言']
個計	['信十固']
古言	['口計']
個表	['俵固', '俵十回']
合薬	['中人土楽', '中人士楽', '中十大楽', '一中人十楽']
最集	['取日椎', '果耳隻', '又日椎耳', '日木耳隻']
細粉	['田米紛']
師恩	['一因帥心']
詩脚	['却寺月言']
指肢	['技脂', '技旨月']
集検	['人合木椎', '人唯大林', '人口大木椎']
主働	['住動']
松韻	['公果賠', '公員木音', '公唄木音', '公日木賠']
証得	['征旦討', '一征日討', '寸征旦言', '一寸征日言']
触接	['女拉虫角']
真趣	['八取直走', '具十取走', '具支耳走', '且八取土走', '且八取士走', '八又直耳走', '具十又耳走', '一且八十取走', '一且八支耳走', '且八又土耳走', '且八又士耳走', '一且八十又耳走']
清兵	['浜青']
真味	['具古未', '八口未直', '具十口未', '一且八古未', '且八口土未', '且八口士未', '一且八十口未']
時好	['女子寺日']
侍読	['信売寺']
銃格	['充各木金']
呪詞	['兄口司言']
授時	['受持日']
樹想	['十心村相豆', '十寸心木相豆', '十寸心林目豆', '十心木村目豆']
枢府	['付区床']
聖恩	['呈因恥', '呈因心耳']
盛業	['並成未皿']
星章	['十暗生', '早生音', '十日生音']
青波	['清皮']
清話	['活請', '活言青']
接辞	['女拉舌辛']
節欲	['即欠竹谷']
宣略	['一客旦田', '二客日田']
全乾	['乙人十午旺']
総記	['心紀訟', '公心紀言']
装姿	['壮女次衣']
双耳	['又取']
相念	['今想', '今心木目']
塞源	['一井圧小泊穴']
他域	['一伐口地']
胎齢	['令台月歯']
堪航	['坑甚舟']
弾機	['単幾弓木']
蓄蔵	['玄臣苗茂']
地保	['他吐木']
長弓	['張']
超空	['召工穴走']
聴者	['十恥署', '十心署耳']
貼布	['右巾貞']
庭樹	['十寸床廷豆']
提台	['口払是', '払旦足', '一払日足']
店格	['占各床']
盗取	['又次皿耳']
塔銘	['中人名王針', '中人十名王金']
塔楼	['中人十女木王米']
都校	['木者郊']
渡支	['又度汁']
銅臭	['内呈犬首', '同犬自金']
怒棒	['奉奴心木', '又奉女心木']
二佐	['仁左']
乳木	['孔采']
陪膳	['善月部']
白舟	['舶']
白描	['拍苗']
博約	['勺十縛']
帆装	['凡壮巾衣']
梅樹	['午寸林母豆', '午木村母豆']
幕威	['天女巾日茂']
非俗	['俳谷']
分賦	['武貧']
分米	['粉']
聞略	['田耳閣']
壁泉	['十培尿白', '吐尿白辛']
保蔵	['休口臣茂']
棒材	['奉才林']
帽針	['冒十巾金']
明笛	['日月由竹']
名鐘	['童銘']
明誠	['成日月言']
迷入	['米込']
黙念	['今心犬黒']
訳業	['並尺未言']
訳例	['信列尺']
誘眠	['民目秀言']
葉温	['世旧木汁皿']
要脚	['却腰']
溶銑	['容洗金']
翼胴	['共同羽胃', '同月異羽', '共同月田羽']
藍晶	['日旧早監']
乱神	['申礼舌']
略意	['各思音', '各心田音']
略章	['十各田音', '各日田辛']
例歌	['何列可欠']
和鉄	['口秩金']
安鎮	['女直穴金', '一且女穴針', '一八女宜針', '且土女穴金', '且士女穴金', '八土女宜金', '八士女宜金', '一且十女穴金', '一八十女宜金']
異汗	['干洪田']
異材	['共才木田']
異俗	['供田谷']
異読	['共売田言']
異版	['共反片田']
運刀	['軍辺']
映演	['央旦油穴', '一央日油穴']
永言	['詠']
英略	['各央苗']
液柱	['夜木注']
温食	['人日浪皿']
温中	['日沖皿']
音吐	['培日']
械具	['一八戒査', '一且八戒木']
皆働	['伯動比']
加授	['受拐']
歌体	['何可本欠']
河伯	['何泊']
花明	['化十旧月']
寡欲	['具刃容欠', '一且八刃容欠', '一且刃欠穴谷', '一八刃宜欠谷']
乾塩	['乞午吐早皿', '乞十午吐日皿']
勘検	['人大架甚', '人加大木甚']
乾固	['乙十午回早']
管板	['反棺竹', '反官木竹']
勘略	['各甚男']
艦齢	['令歯監舟']
概日	['既果']
含味	['口吟未']
起句	['包口走']
期節	['一八即竹骨']
器胎	['口台品月犬']
恐婚	['凡女工心日氏']
強拍	['弓払白虫']
供木	['休共']
禁戒	['木械示']
禁区	['木枢示']
禁庭	['廷示麻', '床廷木示']
議婚	['女日氏義言']
議突	['犬穴義言']
空曹	['工旦曲穴', '一工日曲穴']
句間	['問旬']
景雲	['京曇']
計機	['十幾木言']
乾雲	['乙十午曇']
賢才	['又臣財']
献詞	['南司犬言']
健章	['位建早', '位十建日']
激暑	['放日泊者']
古意	['口心章', '十口心音', '口心日辛']
講員	['口言購', '井再唄言']
校勘	['効木甚']
校紀	['己木絞']
口型	['刑吐']
郊祭	['交際']
好時	['女子寺日']
好晴	['女子日青']
好相	['女子木目']
公伯	['仏八白']
厚壁	['圧子居音']
湖魚	['古月漁', '十口月漁']
枯樹	['十喜寸林', '十喜木村', '十古寸林豆', '十古木村豆']
個装	['依固壮', '依十回壮']
混食	['人昆浪', '人日比浪']
合著	['中人土者', '中人士者', '中十大者', '一中人十者']
業欲	['並未欠谷']
昨譜	['日普詐']
錯簡	['昔竹金間']
在命	['一印舎', '印吐大', '一人印吐', '人印口王']
詩宴	['安時言', '安寺日言']
市県	['亡小巾目']
試査	['且式木言']
枝指	['技旨木']
詩趣	['取寺言走', '又寺耳言走']
試植	['一式査計', '土式査言', '士式査言', '式木直言', '一且式木計', '一十式査言', '且土式木言', '且士式木言', '一且十式木言']
支村	['寸枝', '十又寸木']
試釣	['勺式言金']
師部	['一帥陪']
集取	['又椎耳', '木耳隻']
拾集	['合推木', '口大推木', '一人口推木']
臭腺	['月泉犬自']
宗要	['安票']
趣好	['取女子走', '奴子耳走', '又女子耳走']
守国	['団宝']
主木	['柱']
招運	['口揮辺']
掌侍	['付堂手']
章草	['十旧早辛']
諸陣	['言車都']
真刀	['分直', '且分土', '且分士', '一且分十']
直答	['且合土竹', '且合士竹', '一且十合竹', '一且古大竹', '且二人古竹', '且口土大竹', '且口士大竹', '一且人口土竹', '一且人口士竹', '一且十口大竹', '且二人十口竹']
時言	['日詩']
字幅	['子富巾']
縦欄	['従練閑']
樹影	['京寸早杉豆', '十寸景杉豆', '京十寸日杉豆']
呪禁	['兄口林示']
呪布	['兄右巾']
城鎮	['且八成王針', '且八十成王金']
吹笛	['口欠由竹']
数検	['人合女枚米', '人大如枚米', '人口大女枚米']
請期	['一八言青骨']
製鉱	['制広衣金']
清真	['具汁青', '一且八汁青']
聖日	['口旺耳']
精誠	['成米請', '成米言青']
整曹	['政旦曲束', '一政日曲束']
製銅	['制同衣金']
星林	['木果生']
責付	['債寸']
戦債	['伐単責']
船隻	['唯般']
全誌	['志詮']
全麻	['床栓']
相依	['休目衣']
相悪	['亜想', '亜心木目']
宗女	['安示']
草聖	['旺耳苦']
双塔	['中人又支王']
側衛	['偉則行']
測標	['則木漂']
損賠	['員唄拉']
増植	['十曽査王', '且十曽木王']
増福	['一口曽田社']
俗談	['信炎谷']
俗歌	['何可欲', '何可欠谷']
大圏	['因巻']
体構	['井休再本']
胎毒	['台母青']
体認	['信忍本']
胆略	['各旦胃', '一各日胃', '一各明田', '各旦月田', '一各日月田']
大一	['天']
男工	['功田']
潮差	['工朝洋', '十工早月洋']
超抜	['友招走']
直積	['土租責', '士租責', '一十租責']
珍案	['全安杉']
敵楼	['嫡枚米']
転給	['一口絵車']
転依	['伝衣車']
泥塔	['中人尼汁王']
討究	['九八守言', '九寸穴言']
倒懸	['一且係到小心']
桃符	['付兆木竹', '休兆寸竹']
筒部	['同竹陪']
特演	['一寺油牛穴', '八守油牛王', '寸油牛王穴']
銅鼓	['同支豆針', '十又同豆針', '十同支豆金']
同山	['両口']
銅粉	['分同米金']
土窟	['堀穴']
内堤	['丙日走']
軟飯	['反車飲']
日精	['晴米']
粘弾	['単占弓米']
背方	['北肪']
俳話	['信舌非']
白指	['拍旨']
繁簡	['敏竹糸間']
藩侯	['候汁番']
藩司	['万中汁田米', '一中刀汁田米', '一中力汁田米']
貝器	['品員犬', '品唄犬']
幕議	['巾我旧美計', '十巾我旧美言']
幕法	['去巾漠']
悲調	['周心言非']
標木	['林票']
描破	['拓皮苗']
封口	['吐寺']
噴版	['一中千片販', '千又員斤片', '千又唄斤片']
仏器	['伏台品']
分治	['公沼']
便柱	['住梗']
法空	['去江穴']
奉伺	['俸司']
倣製	['依制放']
歩法	['去渉', '去止沙']
亡姉	['一妄巾']
帽章	['冒十巾音', '冒巾日辛']
木主	['柱']
盆器	['八召品犬皿', '分口品犬皿']
明器	['口品日月犬']
盟誓	['折明皿言', '折日月皿言']
溶鍛接	['安拉段浴金']
陽鋳	['一寸易邦金']
翼弦	['共弓畜羽', '弓玄異羽', '共弓玄田羽']
翼棟	['木東異羽', '共木東田羽']
略装	['各壮田衣']
略符	['付各田竹']
列仙	['例山']
路標	['口格止票', '口各木止票']
路糧	['口各止米量']
哀思	['口心田衣']
悪演	['一亜心油穴']
悪蛮	['亜恋虫']
悪器	['亜口品心犬']
悪計	['亜十心言']
暗空	['工日穴音']
暗愁	['意日秋', '心日秋音']
安導	['女守道']
暗流	['充日旧泣']
意企	['人心止音']
異校	['交共木田']
一二	['三']
異朝	['共十早胃', '共十早月田']
衣糧	['旦米裏', '一日米裏']
引接	['女弔拉']
飲膳	['人善朗欠']
詠吟	['含永言', '今口永言']
詠者	['永諸']
詠藻	['串枯泳言', '中口枯泳言', '串口木泳計', '串古木泳言', '中口古木泳言', '串十口木泳言', '串口木永汁言']
英哲	['中十央折']
演示	['一八宗油']
応機	['幾床心']
皆空	['工比白穴']
介詞	['万中人言', '中刀大言', '中力大言', '一中人刀言', '一中人力言']
解嘱	['召属牛角']
解嘲	['召朝牛角', '十召早月牛角']
楷法	['去木比泊']
苛課	['口菓訂', '可菓言']
架器	['加口品木犬']
夏枯	['土格自', '士格自', '一十格自', '各土木自', '各士木自', '一十各木自']
仮足	['促反']
滑音	['日泣骨']
花路	['中化十各止']
艦師	['一帥監舟']
棺床	['官麻']
管針	['十官竹金']
乾浄	['乞争早汁', '乙争午日汁', '乞争十日汁']
歓想	['心権欠目']
乾法	['乞去早汁', '乙午去日汁', '乞十去日汁']
雅言	['牙誰']
忌器	['口品己心犬']
期始	['一公如骨', '一八台女骨', '一公口女骨']
紀路	['口己止絡']
吉符	['仕口寸竹']
奇謀	['椅甘言']
宮禁	['呂宗林']
鏡花	['児化辛金']
恐習	['凡工心白羽']
胸章	['凶旬月辛']
今古	['十吟', '十含']
禁婚	['女日林氏示', '女木果氏示']
緊接	['又姫拉糸', '奴拉糸臣', '又女拉糸臣']
錦袋	['代巾白衣金']
義訓	['川議']
偽足	['促為']
儀表	['俵義']
逆胴	['同遡']
暁空	['元千工旧穴', '八千完工旧']
漁歌	['可欠河魚']
玉室	['宝至']
魚濫	['漁監']
銀板	['反根金']
掘設	['屈投言']
具陳	['一八東阻']
愚迷	['心米遇']
軍持	['寺揮']
警異	['共敬田言']
景趣	['京最走', '主小最足', '京取日走', '主取小日足', '京又日耳走', '主又小日耳足']
恵存	['不子心由']
警帽	['冒巾敬言']
欠口	['吹']
倹勤	['人僅加大']
健士	['仕建']
献信	['伏南言']
犬儒	['伏需']
献腎	['南又月犬臣']
賢哲	['又員折臣', '又唄折臣']
肩翼	['共扇胃', '扇月異', '共扇月田']
鯨波	['京漁皮', '涼皮魚']
舷直	['且土玄舟', '且士玄舟', '一且十玄舟']
好期	['一八女子骨']
校具	['一交八査', '一且交八木']
公健	['仏八建']
構材	['井再才林']
恒説	['一悦旦言', '二悦日言']
幸存	['在子平']
肯諾	['中有止計', '月止若言', '中十有止言']
洪博	['共十寸浦']
鋼棒	['奉岡木金']
講明	['井再日月言']
校廊	['交床郎']
古賢	['員支臣', '唄支臣', '十又員臣', '十又唄臣']
鼓章	['支早豆辛', '十又早豆辛', '十支日豆辛']
古聖	['十口呈耳']
湖盆	['八十月沼皿', '八召月汁皿', '分口月汁皿']
枯林	['古森', '十口森']
混芽	['旧比汁牙']
合力	['加大', '一人加']
護念	['今又芯誰', '今芯言隻']
才藻	['串口材汁']
最略	['取各日田', '又各日田耳']
錯倒	['借到金']
錯読	['売昔言金']
察番	['審祭']
財副	['一則口才田']
斬法	['去漸']
詩格	['各寺木言']
思議	['心田義言']
試婚	['女式日氏言']
思路	['口心止略', '口各心止田']
支軸	['十又由車']
試製	['制式衣言']
試草	['十式旧計']
詩草	['十寺旧計']
詩体	['侍本言', '信寺本']
司調	['周詞']
市鎮	['六巾直金', '一且六巾針', '且六土巾金', '且六士巾金', '一且六十巾金', '且全八十巾立']
失透	['秀迭']
射界	['介寸田身']
遮眼	['庶目退']
借音	['位日昔']
車床	['庫木']
斜軸	['余斗由車']
集運材	['才林軍進']
集蔵	['椎臣茂']
終売	['冬続']
主桁	['柱行']
種植	['土木租重', '士木租重', '一十木租重']
殊別	['刀列口朱', '列力口朱']
松幹	['人公十干早木']
将器	['名品寸状']
小給	['不人口糸']
憧景	['憬童']
章京	['景辛']
相府	['付床目']
唱門	['口日間']
植相	['林目直', '且土林目', '且士林目', '土木査目', '士木査目', '一且十林目', '一十木査目']
植福	['二枯田祖', '二古木田祖', '一口土木田祖', '一口士木田祖', '二十口木田祖']
諸聖	['呈者耳言']
姿容	['安次谷']
支翼	['十又異羽', '共十又田羽']
誌齢	['令志歯言']
指話	['括詣', '括旨言']
慎機	['十幾惧木']
真誠	['具成計', '八成直言', '具十成言', '一且八成計', '且八土成言', '且八士成言', '一且八十成言']
真福	['二八古田祖', '一八口土田祖', '一八口士田祖', '二八十口田祖']
次妻	['凄欠']
寺舎	['人口封']
時針	['寺早金', '十寺日金']
自心	['息']
時装	['壮寺日衣']
寺搭	['中人土持', '中人士持', '中十大持', '一中人十持']
磁波	['滋破']
銃塔	['中人充王針', '中人充十王金']
授章	['受拉早', '十受拉日']
呪標	['兄口木票']
樹容	['十守木谷豆']
浄闇	['争泣間']
叙論	['二内又茶言']
頭燃	['然煩豆']
盛宴	['安成日皿']
清快	['情決']
聖鑑	['呈監耳金']
聖業	['並呈未耳']
清苦	['中十汁青']
正訓	['川証']
精講	['井再米請', '井再米言青']
精鉱	['広米金青']
姓字	['子安生']
聖樹	['十呈村耳豆', '十呈寸木耳豆']
聖壇	['主呈回旦耳', '一主口回旺耳', '一主呈回日耳']
精銅	['同米金青']
晴和	['口青香']
斥言	['訴']
節略	['即各田竹']
仙音	['位山日']
洗骨	['先滑']
詮曹	['全旦曲言', '大旺曲言', '一人旺曲言', '一全日曲言']
仙壇	['主但回山']
全率	['八玄針', '八十玄金']
装架	['加壮木衣']
装載	['壮裁車']
壮衰	['一口装']
草沢	['十尺旧汁']
桑林	['又双森']
側注	['住測']
粗細	['田米組']
粗紙	['氏米組']
遡時	['寺明逆', '寺日月逆']
組積	['租績']
粗動	['助米重']
俗諦	['信帝谷']
俗話	['信舌谷']
退隊	['遂限']
担荷	['中但十打']
炭管	['官山灰竹']
短呪	['兄知豆']
諾意	['右芯言音', '心若言音', '右心旧言辛']
奪略	['各奮寸']
弾芯	['十単弔心', '十単引心']
鋳植	['一寿査針', '土寿査金', '士寿査金', '寿木直金', '一且寿木針', '一十寿査金', '且土寿木金', '且士寿木金', '一且十寿木金']
調器	['口周品犬言']
長脚	['却脹']
朝権	['十午椎胆', '十午胆集', '午土明椎', '午土明集', '午士明椎', '午士明集', '一十午明椎', '一十午明集', '一午早月椎', '一午早月集', '十午旦月椎', '十午旦月集', '午土日月椎', '午土日月集', '午士日月椎', '午士日月集', '一十午日月椎', '一十午日月集']
朝護	['肢草誰', '支月草誰', '月草計隻', '十又月草誰', '十月草言隻']
弔銃	['充引金']
腸整	['一政易月束']
彫板	['反周杉']
直音	['一且章', '且旦辛', '一且日辛']
直宰	['土宜辛', '士宜辛', '一十宜辛']
勅答	['加大束竹', '一人加束竹']
直読	['一且売計', '且土売言', '且士売言', '一且十売言']
堤高	['主同日足']
提立	['拉是']
田紳	['申細']
透輝	['光秀運']
党舎	['人兄堂']
湯酔	['九土易酒', '九士易酒', '一九十易酒']
透入	['秀込']
等倍	['培符', '付培竹', '位口寺竹', '位吐寸竹']
糖量	['唐糧']
特招	['召持牛']
特錬	['寺東牛金']
同況	['兄洞']
銅胆	['旦胴金', '一同明金', '一日胴金', '同旦月金', '一同日月金']
銅盤	['同皿般金']
土階	['白陛']
奴輩	['又女車非']
軟堅	['欠臣軽']
粘炭	['占山灰米']
背脇	['北月脅']
俳士	['仕非']
背射	['北肘身', '北寸月身']
排石	['拓非']
拝陽	['一揚邦']
白暁	['元卑旧']
泊食	['人浪白']
白水	['泉']
箱桁	['木相竹行', '林目竹行']
破婚	['妬日氏皮']
破粋	['皮砕米']
搬機	['幾投木舟']
繁錯	['敏昔糸金']
半仙	['伴山']
抜苦	['技若']
皮溝	['井再波']
風樹	['千寸机虫豆']
副章	['一剖早田', '剖十旦田', '剖土日田', '剖士日田', '一剖十日田']
付節	['即符']
腐木	['付床肉']
部兵	['丘八陪']
豊鉱	['広曲豆金']
褒詞	['休司哀言', '伺哀木言', '保司衣言', '信司哀木', '休口司衣言', '伺口木衣言', '依口司木言', '信口司木衣']
豊腰	['曲月要豆']
保香	['休和日']
帆材	['凡巾才木']
保章	['休古音', '位古果', '位日枯', '倍十果', '倍早木', '休十口音', '休口日辛', '位十口果', '位口早木', '位古日木', '倍十日木', '位十口日木']
本金	['鉢']
翻心	['必田米羽']
翻字	['子審羽']
某区	['枢甘']
謀主	['柱甘言']
亡念	['今忘']
暴富	['丁共口曽穴']
盆期	['一八分皿骨']
盆景	['京分日皿', '六小昭皿', '六召小日皿']
幕材	['巾才模']
魔封	['塊寺麻', '塊寺床木']
妙演	['一八女宙沙', '一八安沙由', '一女沙由穴']
明旦	['日胆']
明門	['月間']
明界	['介日胃', '介日月田']
明鑑	['日月監金']
明誓	['折日月言']
明答	['人口竹胆', '合日月竹', '人口旦月竹', '口大日月竹', '一人口日月竹']
明部	['日月陪']
木門	['閑']
誘脅	['秀脇言']
有取	['友月耳']
優賞	['償憂']
癒香	['人心痢胆', '大心明痢', '一人心明痢', '人心旦月痢', '大心日月痢', '一人心日月痢']
輸租	['且利大月車', '一且人利月車']
養肝	['一幸月食', '平月王食']
要償	['価女賞']
腰側	['価則女月']
腰盤	['月皿般要', '皿股舟要']
落輪	['人冊十各汁車']
流融	['一充冊況虫']
良人	['食']
林区	['木枢']
林松	['公森']
累月	['糸胃']
例式	['代列工']
論者	['一内著言']
